23
22
WWWWWWWWWWWWWWWWWWWWWWW
W1PPPPPPPPPWPPPPPPPPP4W
WPWWWPWWWWPWPWWWWPWWWPW
WPWWWPWWWWPWPWWWWPWWWPW
WPPPPPPPPPPPPPPPPPPPPPW
WPWWWPWPWWWWWWWPWPWWWPW
WPPPPPWPPPPWPPPPWPPPPPW
WWWWWPWWWW W WWWWPWWWWW
WPPPPPW         WPPPPPW
WPWWWPW WWW WWW WPWWWPW
WPPPPP     G     PPPPPW
WPWWWPW WWW WWW WPWWWWW
WPPPPPW         WPPPPPW
WWWWWPW WWWWWWW WPWWWWW
WPPPPPPPPPPWPPPPPPPPPPW
WPWWWPWWWWPWPWWWWPWWWPW
WPPPWPPPPPPPPPPPPPWPPPW
WWWPWPWPWWWWWWWPWPWPWWW
WPPPPPWPPPPWPPPPWPPPPPW
WPWWWWWWWWPWPWWWWWWWWPW
W3PPPPPPPPPPPPPPPPPPP2W
WWWWWWWWWWWWWWWWWWWWWWW